1111111111
1000000001
1002002001
1000000001
1000110001
1000000001
1020000201
1000000001
1111100111
1111111111